à ---> û
á ---> ç
â ---> è
ã ---> õ
ä ---> ö
å ---> ù
æ ---> â
ç ---> ê
è ---> ï
ê ---> ì
ë ---> þ
ì ---> ñ
í ---> í
î ---> ð
ï ---> ó
ð ---> æ
ñ ---> ÷
ò ---> á
ó ---> à
ô ---> ü
õ ---> å
ö ---> î
÷ ---> ã
ø ---> ô
ù ---> ø
û ---> ä
ü ---> ò
ý ---> ý
þ ---> ë
ÿ ---> ÿ
" " -> ¸